NO ./imgs/Ice.xpm

SO ./imgs/WoolSnow.xpm
EA ./imgs/Coal.xpm
WE ./imgs/Bricks.xpm


C   135,206,235   

F 255,255,255 

                       111111111111
                        10000000001
                        10000000001
                         100000001
1111111111111111111111111111000001
100000000000000000000000000000001
10011111111011111111111111000001
10001    110000000000000001111111
11011    111111111111111101                           111111
100011111110000000000000001                          10000001
10001000011011111111111111111111111111111           1000000001
1000000001101               1000000000001          100000000001
1000100001101               100000000000111111111110000000000001
100011111110111111          100000000000000000000000000000000001
100011000000000001          100000000000111111111110000000000001
100011000000000001          1000000000001          100000000001
10001101111111111111111111111000000000001           1000000001
10000001000000000000000000000000011111111            10000001
1000000100000000011111111111110001                    111111
100000010000000001           10001
100000010000000101           10001
100000010000000001           10001
100000010000000001           10001
100000010100000001          10001
100000010111000001         10001
100000010001000001        10001
100011111111111111       10001
10001            111111 10001
1001          11100000010001
101         110000000000001
101        10000000000000001
101       1000000000000000001
101111111100000000000000000001
100000000000000000000N00000001
111111111100000000000000000001
          1000000000000000001
           10000000000000001
            110000000000011
              11100000111
                 11111