NO ./imgs/Bark.xpm
SO ./imgs/Bricks.xpm
WE ./imgs/Dirt.xpm
EA ./imgs/Coal.xpm

C 135,206,235
F 36,85,1

1111111111111111111111111
1000000000110000000000001
100000000000000000001S001
1011000001110000000000001
1000000111111111110000001
10000001         10000001
10000001         10000001
10000001         10000001
10000001         10000001
1000000111111111110000001
1000000000000000000000001
1000000000000000000000001
1000000111111111110000001
10000001         10000001
10000001         10000001
10000001         10000001
10000001         10000001
1000000111111111110000001
1000000000000000000000001
11110111111111011100000011111
11110111111111011101010010001
11000000110101011100000000001
10000000000000001100100010001
10100000000000001100000010001
100000000000000011010100100011111
110000011101010111110111100000001
11110111 1110101 1 1111 100011111
11111111 1111111 111111111111 111
