NO ./imgs/Bark.xpm
SO ./imgs/Bricks.xpm
WE ./imgs/Dirt.xpm
EA ./imgs/Coal.xpm

C 51,53,51
F 36,85,1

1111111111111111111111111
1000000000000000000000001
100011111111110000001W001
1000000000000000000000001
1111111111111111111111111
