111111
1000C0
11E0P1
101001
111111
